"filename", "language", "JavaScript", "CSS", "comment", "blank", "total"
"c:\Users\me\Desktop\React\learning_projects\productivity-app\src\App.css", "CSS", 0, 44, 0, 15, 59
"c:\Users\me\Desktop\React\learning_projects\productivity-app\src\App.js", "JavaScript", 32, 0, 0, 4, 36
"c:\Users\me\Desktop\React\learning_projects\productivity-app\src\index.js", "JavaScript", 9, 0, 0, 2, 11
"c:\Users\me\Desktop\React\learning_projects\productivity-app\src\pages\Dashboard.js", "JavaScript", 7, 0, 0, 2, 9
"c:\Users\me\Desktop\React\learning_projects\productivity-app\src\pages\Home.js", "JavaScript", 7, 0, 0, 2, 9
"c:\Users\me\Desktop\React\learning_projects\productivity-app\src\pages\Login.js", "JavaScript", 7, 0, 0, 2, 9
"c:\Users\me\Desktop\React\learning_projects\productivity-app\src\pages\MindmapPage.js", "JavaScript", 7, 0, 0, 2, 9
"c:\Users\me\Desktop\React\learning_projects\productivity-app\src\pages\PlanningPage.js", "JavaScript", 7, 0, 0, 2, 9
"c:\Users\me\Desktop\React\learning_projects\productivity-app\src\pages\Profile.js", "JavaScript", 7, 0, 0, 2, 9
"c:\Users\me\Desktop\React\learning_projects\productivity-app\src\pages\Register.js", "JavaScript", 7, 0, 0, 2, 9
"c:\Users\me\Desktop\React\learning_projects\productivity-app\src\pages\Settings.js", "JavaScript", 7, 0, 0, 2, 9
"c:\Users\me\Desktop\React\learning_projects\productivity-app\src\pages\TodoListBoardPage.js", "JavaScript", 7, 0, 0, 2, 9
"c:\Users\me\Desktop\React\learning_projects\productivity-app\src\utility-components\ChangeThemeButton.js", "JavaScript", 38, 0, 0, 4, 42
"Total", "-", 142, 44, 0, 43, 229